Tomorrow, When the War Began - Marsden - Tomorrow Series
Friday - Heinlein
Moon is a Harsh Mistress - Heinlein
Starship Troopers - Heinlein
Cat Who Walked Through Walls - Heinlein
Expanded Universe  - Heinlein
Best Of - Heinlein
Reality Dysfunction - Hamilton - Nights Dawn Trilogy
Naked God - Hamilton - Nights Dawn Trilogy
Great North Road - Hamilton
Mort - Pratchett - Discworld Series
Valis - Dick
Mocking Bird - Tevis
Anthem - Rand
Red Mars - Robinson
Changes, The - Dickson
Down and Out in Paris and London -  Orwell
Way of Zen - Watts
Looking for Mo - Duane
Martian Time-Slip  - Dick
Orkneyinga Saga -
Day of the Triffids - Wyndham
Buddhist Scriptures - Lopez
Eureka Stockade - Carboni
Definitive Guide to HTML5 Video -  Pfeiffer
Introducing HTML5 - Lawson, Sharp
Making of the English Working Class - Thompson *
Practical Shooting Beyond Fundamentals - Enos *
Australian Bushcraft - Plate *
Bushcraft - Kochanski *
Bushcraft - Mears *
Journety of Survival - Blackwell
Fieldbook for Australian Scouts
Camping and Woodcraft - Kephart
Mountiancraft and Leadership - Langmuir *
Survival Manual - US Airforce
More Bush Leatherwork - Edwards *
One Straw Revolution - Fukuoka
Cassel School Dictionary Latin English
Small Scale Grin Raising  - Logsdon
Handbook for Wool Growers - Australian Wool Board
Peak District - Edwards *
Woodwork in Theory and Practice - Walton
Homicidal Psycho Jungle Cat - Watterson *
Bee Ag Skills -  NSW DPI
Skills and Drills -  Stoeger *
Short Circuit -  Jaycar
Geology of Matlock Mines - Ford
Dr Who Time frame - Howe *
Advanced Aikido - Dang, Seiser
Starting Strength - Rippetoe  *
Advanced Dungeons and Dragons - Gygax *
Himalaya - Palin
